with - c;
was - был;
it - это;
there - там;
they - они;
her - ей/её;
were - мы;
things - вещи;
cupboard - шкаф;
three - три;
chairs - стулья;
near - возле;
neither/nor - ни, также не, тоже ни;
even - даже;
grass - трава; 
laughed - рассмеялся;
began - начал;
early - рано;
evening - вечер;
often - часто;
because - потому что;
dear -  уважаемые;
hair - волосы;
nose - нос;
run and played - бегать и играть;
afternoon - после полудня;
at - в;
of - из;
cried - плакала;
how - как;
terriable - ужасный;
he run off - он убежал;
after - после;
horses - лошади;
came - пришел;
frightened - испуганный;
into - в;
her arms - ее руки;
at that - при этом;
terrible thing happened - случилось ужасное;
lifted - поднятый;
then - затем;
carried - унесло;
far away - далеко;
did not - не;
wanted to - хотеть;
what will happen to us - Что будет с нами;
thought - думал;
passed - прошло;
shall - должен;
got up - вставать;
lay - прокладывать;
beside - рядом;

when - когда;
sat - сидеть;
around - вокруг;
early - рано;
cried - кричать;
saw - увидел;
bright - яркий;
sang - спели;
their - их;
way - путь;
fairy-land - сказочно-земля;
thought - думал;
bright - яркий;
were - мы;
comming to the house - идти к дому;
what - какие;
like - как;
we - мы;
why - зачем;
asked - спросил;
because - потому как;
wicked - злой;
answered - ответил;
does - делает;
could - мог;
kind - доброта;
there - там;
mistake - ошибка;
answered - ответил;
How - Как;
said - сказал;
feet under - ноги под;
saw - увидел;
frightened - испуганный;
what shall - что;
cried out - выкрикнул;
fell - упал;
poor - бедный;
but who - но кто;
made - сделал;
now they - теперь они;
has fallen - упал;
where - где;
are there - есть там;
there are - это так;
of them - из них;
lives - живёт;
glad - довольны;












